#######################
..X.....
.....X.................
........X..............
...........X...........
..............X........
.................X....
....................S..
.......................
.......................
.......................
.......................
.......................
#..#..#..#..#..#..#......
.........2.............
.......................
#########################