####################
#.3................#
#..................#
####################
##.1..............##
#.#..............#.#
#..#..........2.#..#
#...#..........#...#
#....#........#....#
#.....#......#.....#
#.X..S1#....#1S..X.#
#..C....#..#....C..#
####################
#.@...3.........1..#
#..................#
####################
