.....................
.....................
.....................
............0........
.....................
............#........
.....................
.....................
..........#####......
.........X.....X.....
............C........
.......###########...
.........S.....S.....
............3........
.....................
....################.
.....................
