....................
...###########.0####
..#................#
.#..........C..#...#
#.....#...#######.##
.....#....#.....#..#
....#.....#...0.#..#
...#......#.....#..#
..#.......#...###.##
..........#...X....#
#.........#........#
.#........#######..#
..#....S......S.....
...#................
....################
....................
