.##.................
.#.....X............
.#..................
.###########........
.#.0.X..............
.#..................
.#####S.............
....................
.....###....###.....
.S..................
......0......0......
###.......X......###
......#......#......
....XX..####....0...
....................
####################
