....................
C...................
#...................
....................
...XSXX.............
....................
##########........#.
..........####......
...H...........#....
...#.#..............
....................
.......#......#.....
....................
....................
.X....0......X.X...#
....#...#...........
