....................
....................
###.................
....................
............2.......
FSSS................
...........###......
####................
......#.............
.....##........1....
..................##
...............#####
#######......#######
#.....##.......#####
#.@...4...F.......##
#................C..
