....................
....................
....................
....................
....................
FSSS................
....................
####................
......#.............
.....##.............
....................
....................
#######.............
#.....##............
#.@...4.............
#...................
