####################
.....4#.............
...C..#.............
#######.............
....................
......##............
...........##.......
......X.........##..
.............##...##
...######...........
....................
#....2..............
..#.........1......
....##..C...........
..@....##...#.......
...........##.......
.
