#####################
#...................#
#.0...............0.#
.#C.S..............#.
..#...S...........#..
...##...........##...
.....##.......##.....
.....................
....#...........#....
..........#..........
.....................
...###.........###...
......#.......#......
.......#.....#.......
.........###.........
.....................
