#######################
.......................
..3................C...
............S......##..
..##..................
........#...#.#.#......
.......................
..####.............####
.......................
........####...........
.......................
...............##.......
.......................
...####.................
...........##..........
.......................
.......................