####################
....................
.......###..........
.#..................
...##...............
......##............
...........##.......
......X.........##..
.............##...##
...######...........
....................
#....2..............
..#.........1.......
....##..CCC.........
..@....##...#....F..
...........##.......
