###################.
....................
.......###..........
.#..................
...##...............
......##............
...........##.......
.@..............##..
.............##...##
...######...........
....................
#...................
..#.................
....##..............
.......##......#.#.#
...........##..###..
