#######################
.......................
..0................C...
............S......##..
..##..................
....X...#...#.#.#......
.......................
..####.............####
.......................
........####...0.......
.......................
....X..........##......
.......................
...####................
...........##..........
.......................
