#######################
.......................
.......###.............
.#.....................
...##..................
......##...............
...........##..........
......X.........##.....
.............##...###..
...######..............
.......................
#....2.................
..#....................
....##..C..............
..@....##...1..........
...........##..........
.......................
