#######################
.......................
.......................
.......................
.......................
.......................
.......................
.......................
.......................
.......................
.......................
...#...................
...#...................
...####................
....3......##..........
.......................
....................
