#######################
.......................
.......###.............
.#.....................
...##..................
......##...............
...........##..........
......X.........##.....
.............##...###..
...######..............
.........W.............
#......................
..#..............1.....
....##......2..........
..@....##..............
...........##..........
....................
