#######################
.......................
.......................
.......................
.......................
.......................
.......................
.......................
.......................
.......................
.......................
...#...................
...#...................
...####................
....0......##..........
.......................
....................
