####################
..3......XX.........
.X.X.X.X....X.X.X.X.
..#......##.........
.#.#.#.######.#.#.#.
......#......#......
...###........###...
S...#....F.....#...S
....#S..#..#..S#....
##..#...####...#..##
....###......###....
.....#S......S#.....
.....#........#.....
..##.###....###.##..
....................
..................#.
